X X X X X X X X X X X X X X X X X X X
X X X X X X X X X X X X X X X X X X X
X X X X X X X X X X X X X X X X X X X
X % X % s % X X X X X X X 5 X 5 X 5 X
X X X - - - X X X X X X X - - - X X X
X X X X X X X X X X X X X X X X X X X
X X X X X X X X X X X X X X X X X X X
X X X X X X X X X X X X X X X X X X X
X X X X X X X X X X X X X X X X X X X
X # X # X # X X X X X X X 2 X 2 X 2 X
X X X X X X X X X X X X X X X X X X X
X X X X X X X X X X X X X X X X X X X
X X X X X X X X X X X X X X X X X X X
X X X ! X ! X ! X X X 0 X 0 X 0 X X X
X X X - - - X X X X X X X - - - X X X
X X X X X X X X X X X X X X X X X X X
X X X X X X X X X X X X X X X X X X X
X 6 X 6 X 6 X X X X X X X 7 X 7 X 7 X
X X X X X X X X X X X X X X X X X X X
p p p u p X X X X X X X X X X X X X X
