X X X X X X X X X X X X X X X X X X X
X ^ X ^ X X X X X X X X X X X 4 X 4 X
X X X X X X X X X X X X X X X X X X X
X X X X X % s % X X X 3 X 3 X X X X X
X X X X X - - - X X X - - - X X X X X
X X X X X X X X X X X X X X X X X X X
X X X X X X X X X X X X X X X X X X X
X X X X X X X ) X X X 1 X X X X X X X
X X X X X X X X X X X X X X X X X X X
X X X X X X X ) X X X 1 X X X X X X X
X X X X X X X X X X X X X X X X X X X
X X X X X X X ) X X X 1 X X X X X X X
X X X X X X X X - - - X X X X X X X X
X 9 X 9 X 9 X X X X X X X 2 X 2 X 2 X
X X - - - X X X X X X X X X - - - X X
X X X X X X X X X X X X X X X X X X X
X X X X X X X X X X X X X X X X X X X
X X X X X 7 X 7 X X X 8 X 8 X X X X X
X X X X X X X X X X X X X X X X X X X
o c o o u X X X X X X X X X X X X X X
