X X X X X X X X X X X X X X X X X X X
X X X X X X X # X # X # X X X X X X X
X X X X X X X X X X X X X X X X X X X
X 4 X 4 X 4 X X X X X X X 1 X 1 X 1 X
X X X X X X X X X X X X X X X X X X X
X X s X X X X @ X @ X @ X X X X X X X
- - - - X X X X X X X X X X X - - - -
X X X X X X X X X X X X X X X X X X X
X X X X X X X X X X X X X X X X X X X
X X X 5 X 5 X 5 X X X 0 X 0 X 0 X X X
X X X - - - X X X X X X X - - - X X X
X X X X X X X X X X X X X X X X X X X
X X X X X X X X X X X X X X X X X X X
X X X 6 X 6 X 6 X X X 7 X 7 X 7 X X X
X X X X X - - - X X X - - - X X X X X
X X X X X X X X X X X X X X X X X X X
X X X X X X X X X X X X X X X X X X X
X X X X X X X X X X X X X X X X X X X
X X X X X X X X X X X X X X X X X X X
o o p u X X X X X X X X X X X X X X X
