X X X X X X X X X X X X X X X X X X X
X X X X X X X X X X X X X X X X X X X
X X X X X X X X X X X X X X X X X X X
X X X 1 X s X 4 X X X 7 X X X 5 X X X
X X X X X X X X X X X X X X X X X X X
X X X 1 X X X 4 X X X 7 - - - 5 X X X
X X X X X X X X X X X X X X X X X X X
X X X 1 X X X 4 X X X 7 X X X 5 X X X
X X X X X X X X X X X X X X X X X X X
X X X X X X X X X X X X X X X X X X X
X X X X X X X X X X X X X X X X X X X
X X X 2 X X X 0 X X X 3 X X X 6 X X X
X X X X X X X X X X X X X X X X X X X
X X X 2 X X X 0 X X X 3 X X X 6 X X X
X X X X X X X X X X X X X X X X X X X
X X X 2 X X X 0 X X X 3 X X X 6 X X X
X X X X X X X X X X X X X X X X X X X
X X X X X X X X X X X X X X X X X X X
X X X X X X X X X X X X X X X X X X X
o o X X X X X X X X X X X X X X X X X
