X X X X X X X X X X X X X X X X X X X
X X X 3 X 3 X 3 X X X X X ^ X ^ X ^ X
X X X X X X X X X X X X X X X X X X X
X X X X X X X X X X X X X X X X X X X
X X X X X X X X X X - - - - - X X X X
X X X X X s X X X X 0 X 0 X 0 X 0 X X
X X X X - - - X X X X X X X X X X X X
X 2 X X X X X X X X X X X X X X X 1 X
X X X X X X X X X X X X X X X X X X X
X 2 X X X X X X X X X X X X X X X 1 X
X X X X X X X X X X X X X X X X X X X
X 2 X X X X X X X X X X X X X X X 1 X
X X X X X X X X - - - - X X X X X X X
X 2 X X X X X X X X X X X X X X X 1 X
X X - - - X X X X X X X X X X X X X X
X X X X X X X X X X X X $ X $ X $ X X
X X b X X X X X X X X X - - - - - X X
X X X % X % X % X X X X X X X X X X X
X X X X X X X X X X X X X X X X X X X
c c c u X X X X X X X X X X X X X X X
